111111111111111111111111111111111111111
111000000000001000001100000000111111111
10000100C100001100000000000001C10000011
100001111100000000010000100000000000011
10000000000011001100010000111000000C111
111P00001000C0000110000E111111100001111
111111111111111111111111111111111111111