1111111111111111111111111111111111
1E0000000000000C000001000000000001
1010010100100000101001000000010101
1010010000101010101001000000010101
1P0000010C0010000000000000000000C1
1111111111111111111111111111111111