1111111111111111111111111111111111111111111111111111111
1000010000000000000000000000000000000000000000000000001
10000100C0000000000000000000000000000000000000000000001
1000010000000000000000000000000000000000000000000000001
111111000000000000000000E000000000000000000000000000001
1000000000000000000000000000000000000000C000000C0000001
1000000000000000000000000000000000000000000000000000001
1P00000000000000000000000000000000000000000000000000001
1111111111111111111111111111111111111111111111111111111